XXXXXXX
XA A AX
X a b X
XA A AX
X c d X
XXXXXXX